1111111111111111
1    7         1
1    7         1
1    7         1
1              3
1              3
1              3
1              3
1              3
1              3
5              4
5     222222   4
5              4
5              4
5              4
1111116666611114
